-1,45,33,33,33,33,33,33,33,33,33,33,33,33,44,-1
-1,36,11,12,16,17,18,19,20,15,13,14,11,12,35,-1
-1,36,22,23,27,28,29,30,31,26,24,25,22,23,35,-1
33,49,3,2,2,0,3,3,3,3,3,0,0,0,48,33
13,15,3,0,2,2,1,0,0,0,2,2,1,0,16,17
24,26,0,1,1,2,1,0,2,2,1,1,2,3,27,28
0,1,0,1,1,2,2,2,1,2,1,1,0,3,3,0
1,1,0,1,0,1,2,2,1,2,2,1,3,3,0,0
34,50,3,3,2,2,2,3,3,0,2,2,0,0,51,34
-1,36,3,0,2,2,2,0,3,3,0,2,2,0,35,-1
-1,36,1,1,0,3,0,3,0,1,1,0,0,3,35,-1
-1,46,34,34,34,34,34,34,34,34,34,34,34,34,47,-1
