-1,45,33,33,33,33,49,1,0,48,33,33,33,33,33,44
-1,36,11,12,13,11,15,1,0,15,18,19,20,16,17,35
-1,36,22,23,24,22,26,1,1,26,29,30,31,27,28,35
33,49,3,3,0,0,1,0,1,0,0,0,3,0,3,35
14,15,0,3,0,0,1,0,1,2,2,2,3,3,0,35
25,26,3,0,3,0,1,3,3,3,3,2,2,1,3,35
0,2,0,0,2,3,1,1,1,0,3,2,0,1,0,35
2,0,1,0,2,0,3,1,1,3,2,2,0,1,1,35
34,50,1,0,2,3,0,1,0,0,2,2,0,3,3,35
-1,36,0,1,2,0,0,2,2,2,2,2,2,0,3,35
-1,36,1,1,1,1,1,0,0,0,0,0,1,1,0,35
-1,46,34,34,34,34,34,34,34,34,34,34,34,34,34,47
