45,33,33,33,33,33,33,33,33,33,33,33,33,33,44,-1
36,11,16,17,18,19,20,15,13,11,12,16,17,13,35,-1
36,22,27,28,29,30,31,26,24,22,23,27,28,24,35,-1
36,0,1,1,1,0,2,2,0,0,0,0,3,0,48,33
36,0,1,2,2,0,0,0,2,0,3,3,3,0,14,12
36,2,1,2,1,1,2,2,2,3,3,0,0,0,25,23
36,2,2,2,1,2,2,2,2,3,3,3,3,3,0,0
36,2,2,2,1,1,2,2,1,1,2,2,0,3,0,0
36,3,0,0,1,1,0,2,2,2,2,2,3,3,51,34
36,3,3,3,3,1,1,1,0,2,2,1,3,0,35,-1
36,0,0,3,3,1,1,0,0,1,0,3,3,0,35,-1
46,34,34,34,34,34,34,34,34,34,34,34,34,34,47,-1
